Kaylyn	Zanussii
Gusella	Millott
Arleta	Atty
Winny	Orts
Celia	Hillen
Nero	Coopman
Guy	Olyfat
Terrel	Clampton
Celisse	Weekes
Rubina	Kuller
Sissie	Beldham
Cissiee	Reisin
Damara	Sissot
Sterling	Shapero
Yovonnda	Pennino
Kare	Souza
Delaney	Edie
Petey	Crutcher
Harlene	Banbrook
Lazaro	Chyuerton
Ruthann	Gendricke
Kippy	Kilbee
Freedman	Gusney
Haroun	Spon
Phaidra	Gersam
Carlos	Hatchett
Talia	Firidolfi
Mathias	Ponting
Krystalle	Orneblow
Kit	Hall
Bennett	Ringe
Auberon	Boorer
Kellia	Dimmne
Katharina	Colston
Garreth	Josilevich
Konrad	Mears
Merry	Brightman
Gayelord	Klausen
Norbie	Pitford
Berget	Gever
